0 0 0 0 0  1 0 0 0 0  2 0 0 0 0  3 0 2 0 1  4 0 2 0 1  5 0 2 0 1  6 0 2 0 1  7 0 0 0 0  8 0 0 0 0  9 0 2 0 1  10 0 2 0 1  11 0 2 0 1  12 0 2 0 1  13 0 0 0 0  14 0 0 0 0  15 0 2 0 1  16 0 2 0 1  17 0 2 0 1  18 0 2 0 1  19 0 0 0 0  20 0 0 0 0  21 0 2 0 1  22 0 2 0 1  23 0 2 0 1  24 0 2 0 1  25 0 0 0 0  26 0 0 0 0  27 0 2 0 1  28 0 2 0 1  29 0 2 0 1  30 0 2 0 1  31 0 0 0 0  32 0 0 0 0  33 0 2 0 1  34 0 2 0 1  35 0 2 0 1  36 0 2 0 1  37 0 0 0 0  38 0 0 0 0  39 0 0 0 0  
0 1 0 0 0  1 1 0 0 0  2 1 0 0 0  3 1 2 0 1  4 1 2 0 1  5 1 2 0 1  6 1 2 0 1  7 1 0 0 0  8 1 0 0 0  9 1 2 0 1  10 1 2 0 1  11 1 2 0 1  12 1 2 0 1  13 1 0 0 0  14 1 0 0 0  15 1 2 0 1  16 1 2 0 1  17 1 2 0 1  18 1 2 0 1  19 1 0 0 0  20 1 0 0 0  21 1 2 0 1  22 1 2 0 1  23 1 2 0 1  24 1 2 0 1  25 1 0 0 0  26 1 0 0 0  27 1 2 0 1  28 1 2 0 1  29 1 2 0 1  30 1 2 0 1  31 1 0 0 0  32 1 0 0 0  33 1 2 0 1  34 1 2 0 1  35 1 2 0 1  36 1 2 0 1  37 1 0 0 0  38 1 0 0 0  39 1 0 0 0  
0 2 0 0 0  1 2 0 0 0  2 2 0 0 0  3 2 2 0 1  4 2 2 0 1  5 2 2 0 1  6 2 2 0 1  7 2 0 0 0  8 2 0 0 0  9 2 2 0 1  10 2 2 0 1  11 2 2 0 1  12 2 2 0 1  13 2 0 0 0  14 2 0 0 0  15 2 2 0 1  16 2 2 0 1  17 2 2 0 1  18 2 2 0 1  19 2 0 0 0  20 2 0 0 0  21 2 2 0 1  22 2 2 0 1  23 2 2 0 1  24 2 2 0 1  25 2 0 0 0  26 2 0 0 0  27 2 2 0 1  28 2 2 0 1  29 2 2 0 1  30 2 2 0 1  31 2 0 0 0  32 2 0 0 0  33 2 2 0 1  34 2 2 0 1  35 2 2 0 1  36 2 2 0 1  37 2 0 0 0  38 2 0 0 0  39 2 0 0 0  
0 3 0 0 0  1 3 0 0 0  2 3 0 0 0  3 3 2 0 1  4 3 2 0 1  5 3 2 0 1  6 3 2 0 1  7 3 0 0 0  8 3 0 0 0  9 3 2 0 1  10 3 2 0 1  11 3 2 0 1  12 3 2 0 1  13 3 0 0 0  14 3 0 0 0  15 3 2 0 1  16 3 2 0 1  17 3 2 0 1  18 3 2 0 1  19 3 0 0 0  20 3 0 0 0  21 3 2 0 1  22 3 2 0 1  23 3 2 0 1  24 3 2 0 1  25 3 0 0 0  26 3 0 0 0  27 3 2 0 1  28 3 2 0 1  29 3 2 0 1  30 3 2 0 1  31 3 0 0 0  32 3 0 0 0  33 3 2 0 1  34 3 2 0 1  35 3 2 0 1  36 3 2 0 1  37 3 0 0 0  38 3 0 0 0  39 3 0 0 0  
0 4 0 0 0  1 4 0 0 0  2 4 0 0 0  3 4 2 0 1  4 4 2 0 1  5 4 2 0 1  6 4 2 0 1  7 4 0 0 0  8 4 0 0 0  9 4 2 0 1  10 4 2 0 1  11 4 2 0 1  12 4 2 0 1  13 4 0 0 0  14 4 0 0 0  15 4 2 0 1  16 4 2 0 1  17 4 2 0 1  18 4 2 0 1  19 4 0 0 0  20 4 0 0 0  21 4 2 0 1  22 4 2 0 1  23 4 2 0 1  24 4 2 0 1  25 4 0 0 0  26 4 0 0 0  27 4 2 0 1  28 4 2 0 1  29 4 2 0 1  30 4 2 0 1  31 4 0 0 0  32 4 0 0 0  33 4 2 0 1  34 4 2 0 1  35 4 2 0 1  36 4 2 0 1  37 4 0 0 0  38 4 0 0 0  39 4 0 0 0  
0 5 0 0 0  1 5 0 0 0  2 5 0 0 0  3 5 2 0 1  4 5 2 0 1  5 5 2 0 1  6 5 2 0 1  7 5 0 0 0  8 5 0 0 0  9 5 2 0 1  10 5 2 0 1  11 5 2 0 1  12 5 2 0 1  13 5 0 0 0  14 5 0 0 0  15 5 2 0 1  16 5 2 0 1  17 5 2 0 1  18 5 2 0 1  19 5 0 0 0  20 5 0 0 0  21 5 2 0 1  22 5 2 0 1  23 5 2 0 1  24 5 2 0 1  25 5 0 0 0  26 5 0 0 0  27 5 2 0 1  28 5 2 0 1  29 5 2 0 1  30 5 2 0 1  31 5 0 0 0  32 5 0 0 0  33 5 2 0 1  34 5 2 0 1  35 5 2 0 1  36 5 2 0 1  37 5 0 0 0  38 5 0 0 0  39 5 0 0 0  
0 6 0 0 0  1 6 0 0 0  2 6 0 0 0  3 6 2 0 1  4 6 2 0 1  5 6 2 0 1  6 6 2 0 1  7 6 0 0 0  8 6 0 0 0  9 6 2 0 1  10 6 2 0 1  11 6 2 0 1  12 6 2 0 1  13 6 0 0 0  14 6 0 0 0  15 6 2 0 1  16 6 2 0 1  17 6 2 0 1  18 6 2 0 1  19 6 0 0 0  20 6 0 0 0  21 6 2 0 1  22 6 2 0 1  23 6 2 0 1  24 6 2 0 1  25 6 0 0 0  26 6 0 0 0  27 6 2 0 1  28 6 2 0 1  29 6 2 0 1  30 6 2 0 1  31 6 0 0 0  32 6 0 0 0  33 6 2 0 1  34 6 2 0 1  35 6 2 0 1  36 6 2 0 1  37 6 0 0 0  38 6 0 0 0  39 6 0 0 0  
0 7 0 0 0  1 7 0 0 0  2 7 0 0 0  3 7 2 0 1  4 7 2 0 1  5 7 2 0 1  6 7 2 0 1  7 7 0 0 0  8 7 0 0 0  9 7 2 0 1  10 7 2 0 1  11 7 2 0 1  12 7 2 0 1  13 7 0 0 0  14 7 0 0 0  15 7 2 0 1  16 7 2 0 1  17 7 2 0 1  18 7 2 0 1  19 7 0 0 0  20 7 0 0 0  21 7 2 0 1  22 7 2 0 1  23 7 2 0 1  24 7 2 0 1  25 7 0 0 0  26 7 0 0 0  27 7 2 0 1  28 7 2 0 1  29 7 2 0 1  30 7 2 0 1  31 7 0 0 0  32 7 0 0 0  33 7 2 0 1  34 7 2 0 1  35 7 2 0 1  36 7 2 0 1  37 7 0 0 0  38 7 0 0 0  39 7 0 0 0  
0 8 0 0 0  1 8 0 0 0  2 8 0 0 0  3 8 2 0 1  4 8 2 0 1  5 8 2 0 1  6 8 2 0 1  7 8 0 0 0  8 8 0 0 0  9 8 2 0 1  10 8 2 0 1  11 8 2 0 1  12 8 2 0 1  13 8 0 0 0  14 8 0 0 0  15 8 2 0 1  16 8 2 0 1  17 8 2 0 1  18 8 2 0 1  19 8 0 0 0  20 8 0 0 0  21 8 2 0 1  22 8 2 0 1  23 8 2 0 1  24 8 2 0 1  25 8 0 0 0  26 8 0 0 0  27 8 2 0 1  28 8 2 0 1  29 8 2 0 1  30 8 2 0 1  31 8 0 0 0  32 8 0 0 0  33 8 2 0 1  34 8 2 0 1  35 8 2 0 1  36 8 2 0 1  37 8 0 0 0  38 8 0 0 0  39 8 0 0 0  
0 9 0 0 0  1 9 0 0 0  2 9 0 0 0  3 9 2 0 1  4 9 2 0 1  5 9 2 0 1  6 9 2 0 1  7 9 0 0 0  8 9 0 0 0  9 9 2 0 1  10 9 2 0 1  11 9 2 0 1  12 9 2 0 1  13 9 0 0 0  14 9 0 0 0  15 9 2 0 1  16 9 2 0 1  17 9 2 0 1  18 9 2 0 1  19 9 0 0 0  20 9 0 0 0  21 9 2 0 1  22 9 2 0 1  23 9 2 0 1  24 9 2 0 1  25 9 0 0 0  26 9 0 0 0  27 9 2 0 1  28 9 2 0 1  29 9 2 0 1  30 9 2 0 1  31 9 0 0 0  32 9 0 0 0  33 9 2 0 1  34 9 2 0 1  35 9 2 0 1  36 9 2 0 1  37 9 0 0 0  38 9 0 0 0  39 9 0 0 0  
0 10 0 0 0  1 10 0 0 0  2 10 0 0 0  3 10 2 0 1  4 10 2 0 1  5 10 2 0 1  6 10 2 0 1  7 10 0 0 0  8 10 0 0 0  9 10 2 0 1  10 10 2 0 1  11 10 2 0 1  12 10 2 0 1  13 10 0 0 0  14 10 0 0 0  15 10 2 0 1  16 10 2 0 1  17 10 2 0 1  18 10 2 0 1  19 10 0 0 0  20 10 0 0 0  21 10 2 0 1  22 10 2 0 1  23 10 2 0 1  24 10 2 0 1  25 10 0 0 0  26 10 0 0 0  27 10 2 0 1  28 10 2 0 1  29 10 2 0 1  30 10 2 0 1  31 10 0 0 0  32 10 0 0 0  33 10 2 0 1  34 10 2 0 1  35 10 2 0 1  36 10 2 0 1  37 10 0 0 0  38 10 0 0 0  39 10 0 0 0  
0 11 0 0 0  1 11 0 0 0  2 11 0 0 0  3 11 2 0 1  4 11 2 0 1  5 11 2 0 1  6 11 2 0 1  7 11 0 0 0  8 11 0 0 0  9 11 2 0 1  10 11 2 0 1  11 11 2 0 1  12 11 2 0 1  13 11 0 0 0  14 11 0 0 0  15 11 2 0 1  16 11 2 0 1  17 11 2 0 1  18 11 2 0 1  19 11 0 0 0  20 11 0 0 0  21 11 2 0 1  22 11 2 0 1  23 11 2 0 1  24 11 2 0 1  25 11 0 0 0  26 11 0 0 0  27 11 2 0 1  28 11 2 0 1  29 11 2 0 1  30 11 2 0 1  31 11 0 0 0  32 11 0 0 0  33 11 2 0 1  34 11 2 0 1  35 11 2 0 1  36 11 2 0 1  37 11 0 0 0  38 11 0 0 0  39 11 0 0 0  
0 12 0 0 0  1 12 0 0 0  2 12 0 0 0  3 12 2 0 1  4 12 2 0 1  5 12 2 0 1  6 12 2 0 1  7 12 0 0 0  8 12 0 0 0  9 12 2 0 1  10 12 2 0 1  11 12 2 0 1  12 12 2 0 1  13 12 0 0 0  14 12 0 0 0  15 12 2 0 1  16 12 2 0 1  17 12 2 0 1  18 12 2 0 1  19 12 0 0 0  20 12 0 0 0  21 12 2 0 1  22 12 2 0 1  23 12 2 0 1  24 12 2 0 1  25 12 0 0 0  26 12 0 0 0  27 12 2 0 1  28 12 2 0 1  29 12 2 0 1  30 12 2 0 1  31 12 0 0 0  32 12 0 0 0  33 12 2 0 1  34 12 2 0 1  35 12 2 0 1  36 12 2 0 1  37 12 0 0 0  38 12 0 0 0  39 12 0 0 0  
0 13 0 0 0  1 13 0 0 0  2 13 0 0 0  3 13 2 0 1  4 13 2 0 1  5 13 2 0 1  6 13 2 0 1  7 13 0 0 0  8 13 0 0 0  9 13 2 0 1  10 13 2 0 1  11 13 2 0 1  12 13 2 0 1  13 13 0 0 0  14 13 0 0 0  15 13 2 0 1  16 13 2 0 1  17 13 2 0 1  18 13 2 0 1  19 13 0 0 0  20 13 0 0 0  21 13 2 0 1  22 13 2 0 1  23 13 2 0 1  24 13 2 0 1  25 13 0 0 0  26 13 0 0 0  27 13 2 0 1  28 13 2 0 1  29 13 2 0 1  30 13 2 0 1  31 13 0 0 0  32 13 0 0 0  33 13 2 0 1  34 13 2 0 1  35 13 2 0 1  36 13 2 0 1  37 13 0 0 0  38 13 0 0 0  39 13 0 0 0  
0 14 0 0 0  1 14 0 0 0  2 14 0 0 0  3 14 2 0 1  4 14 2 0 1  5 14 2 0 1  6 14 2 0 1  7 14 0 0 0  8 14 0 0 0  9 14 2 0 1  10 14 2 0 1  11 14 2 0 1  12 14 2 0 1  13 14 0 0 0  14 14 0 0 0  15 14 2 0 1  16 14 2 0 1  17 14 2 0 1  18 14 2 0 1  19 14 0 0 0  20 14 0 0 0  21 14 2 0 1  22 14 2 0 1  23 14 2 0 1  24 14 2 0 1  25 14 0 0 0  26 14 0 0 0  27 14 2 0 1  28 14 2 0 1  29 14 2 0 1  30 14 2 0 1  31 14 0 0 0  32 14 0 0 0  33 14 2 0 1  34 14 2 0 1  35 14 2 0 1  36 14 2 0 1  37 14 0 0 0  38 14 0 0 0  39 14 0 0 0  
0 15 0 0 0  1 15 0 0 0  2 15 0 0 0  3 15 2 0 1  4 15 2 0 1  5 15 2 0 1  6 15 2 0 1  7 15 0 0 0  8 15 0 0 0  9 15 2 0 1  10 15 2 0 1  11 15 2 0 1  12 15 2 0 1  13 15 0 0 0  14 15 0 0 0  15 15 2 0 1  16 15 2 0 1  17 15 2 0 1  18 15 2 0 1  19 15 0 0 0  20 15 0 0 0  21 15 2 0 1  22 15 2 0 1  23 15 2 0 1  24 15 2 0 1  25 15 0 0 0  26 15 0 0 0  27 15 2 0 1  28 15 2 0 1  29 15 2 0 1  30 15 2 0 1  31 15 0 0 0  32 15 0 0 0  33 15 2 0 1  34 15 2 0 1  35 15 2 0 1  36 15 2 0 1  37 15 0 0 0  38 15 0 0 0  39 15 0 0 0  
0 16 0 0 0  1 16 0 0 0  2 16 0 0 0  3 16 2 0 1  4 16 2 0 1  5 16 2 0 1  6 16 2 0 1  7 16 0 0 0  8 16 0 0 0  9 16 2 0 1  10 16 2 0 1  11 16 2 0 1  12 16 2 0 1  13 16 0 0 0  14 16 0 0 0  15 16 2 0 1  16 16 2 0 1  17 16 2 0 1  18 16 2 0 1  19 16 0 0 0  20 16 0 0 0  21 16 2 0 1  22 16 2 0 1  23 16 2 0 1  24 16 2 0 1  25 16 0 0 0  26 16 0 0 0  27 16 2 0 1  28 16 2 0 1  29 16 2 0 1  30 16 2 0 1  31 16 0 0 0  32 16 0 0 0  33 16 2 0 1  34 16 2 0 1  35 16 2 0 1  36 16 2 0 1  37 16 0 0 0  38 16 0 0 0  39 16 0 0 0  
0 17 0 0 0  1 17 0 0 0  2 17 0 0 0  3 17 2 0 1  4 17 2 0 1  5 17 2 0 1  6 17 2 0 1  7 17 0 0 0  8 17 0 0 0  9 17 2 0 1  10 17 2 0 1  11 17 2 0 1  12 17 2 0 1  13 17 0 0 0  14 17 0 0 0  15 17 2 0 1  16 17 2 0 1  17 17 2 0 1  18 17 2 0 1  19 17 0 0 0  20 17 0 0 0  21 17 2 0 1  22 17 2 0 1  23 17 2 0 1  24 17 2 0 1  25 17 0 0 0  26 17 0 0 0  27 17 2 0 1  28 17 2 0 1  29 17 2 0 1  30 17 2 0 1  31 17 0 0 0  32 17 0 0 0  33 17 2 0 1  34 17 2 0 1  35 17 2 0 1  36 17 2 0 1  37 17 0 0 0  38 17 0 0 0  39 17 0 0 0  
0 18 3 0 0  1 18 3 0 0  2 18 3 0 0  3 18 3 0 0  4 18 3 0 0  5 18 3 0 0  6 18 3 0 0  7 18 3 0 0  8 18 3 0 0  9 18 3 0 0  10 18 3 0 0  11 18 3 0 0  12 18 3 0 0  13 18 3 0 0  14 18 3 0 0  15 18 3 0 0  16 18 3 0 0  17 18 3 0 0  18 18 3 0 0  19 18 3 0 0  20 18 3 0 0  21 18 3 0 0  22 18 3 0 0  23 18 3 0 0  24 18 3 0 0  25 18 3 0 0  26 18 3 0 0  27 18 3 0 0  28 18 3 0 0  29 18 3 0 0  30 18 3 0 0  31 18 3 0 0  32 18 3 0 0  33 18 3 0 0  34 18 3 0 0  35 18 3 0 0  36 18 3 0 0  37 18 3 0 0  38 18 3 0 0  39 18 3 0 0  
0 19 0 0 0  1 19 0 0 0  2 19 0 0 0  3 19 0 0 0  4 19 0 0 0  5 19 0 0 0  6 19 0 0 0  7 19 0 0 0  8 19 0 0 0  9 19 0 0 0  10 19 0 0 0  11 19 0 0 0  12 19 0 0 0  13 19 0 0 0  14 19 0 0 0  15 19 0 0 0  16 19 0 0 0  17 19 0 0 0  18 19 0 0 0  19 19 0 0 0  20 19 0 0 0  21 19 0 0 0  22 19 0 0 0  23 19 0 0 0  24 19 0 0 0  25 19 0 0 0  26 19 0 0 0  27 19 0 0 0  28 19 0 0 0  29 19 0 0 0  30 19 0 0 0  31 19 0 0 0  32 19 0 0 0  33 19 0 0 0  34 19 0 0 0  35 19 0 0 0  36 19 0 0 0  37 19 0 0 0  38 19 0 0 0  39 19 0 0 0  
0 20 0 0 0  1 20 0 0 0  2 20 0 0 0  3 20 0 0 0  4 20 0 0 0  5 20 0 0 0  6 20 0 0 0  7 20 0 0 0  8 20 0 0 0  9 20 0 0 0  10 20 0 0 0  11 20 0 0 0  12 20 0 0 0  13 20 0 0 0  14 20 0 0 0  15 20 0 0 0  16 20 0 0 0  17 20 0 0 0  18 20 0 0 0  19 20 0 0 0  20 20 0 0 0  21 20 0 0 0  22 20 0 0 0  23 20 0 0 0  24 20 0 0 0  25 20 0 0 0  26 20 0 0 0  27 20 0 0 0  28 20 0 0 0  29 20 0 0 0  30 20 0 0 0  31 20 0 0 0  32 20 0 0 0  33 20 0 0 0  34 20 0 0 0  35 20 0 0 0  36 20 0 0 0  37 20 0 0 0  38 20 0 0 0  39 20 0 0 0  
0 21 3 1 1  1 21 3 1 1  2 21 3 1 1  3 21 3 1 1  4 21 3 1 1  5 21 3 1 1  6 21 3 1 1  7 21 3 1 1  8 21 3 1 1  9 21 3 1 1  10 21 3 1 1  11 21 3 1 1  12 21 3 1 1  13 21 3 1 1  14 21 3 1 1  15 21 3 1 1  16 21 3 1 1  17 21 3 1 1  18 21 3 1 1  19 21 3 1 1  20 21 3 1 1  21 21 3 1 1  22 21 3 1 1  23 21 3 1 1  24 21 3 1 1  25 21 3 1 1  26 21 3 1 1  27 21 3 1 1  28 21 3 1 1  29 21 3 1 1  30 21 3 1 1  31 21 3 1 1  32 21 3 1 1  33 21 3 1 1  34 21 3 1 1  35 21 3 1 1  36 21 3 1 1  37 21 3 1 1  38 21 3 1 1  39 21 3 1 1  
