#COLLISION 4 5 20 21 84 86 100 102 116 117 118
84    3   3   3   3   3   3   3   3   3   3   3   3   3   3  86
100   3   3   3   3   3   3   3   3   3   3   3   3   3   3 102
100   3   3   3   3   3   3   3   3   3   3   3   3   3   3 102
100   3   3   3   3   3   3   3   3   3   3   3   3   3   3 102
100   3   3   3   3   3   3   3   3   3   3   3   3   3   3 102
100   3   3   3   3   3   3   3   3   3   3   3   3   3   3 102
100   3   3   3   3   3   3   3   3   4   5   3   3   3   3 102
100   3   3   3   3   3  84   3   3  20  21   3   3   3   3 102
100   3   3   3  84   3 100  84   3   3   3   3   3   3   3 102
116 117 117 117 116 117 116 116 117 117 117 117 117 117 117 118
