84    3   3   3   3   3   3   3   3   3   3   3   3   3   3  86
100   3   3   3   3   3   3   3   3   3   3   3   3   3   3 102
100   3   3   3   3   3   3   3   3   3   3   3   3   3   3 102
100   3   3   3   3   3   3   3   3   3   3   3   3   3   3 102
100   3   3   3   3   3   3   3   3   3   3   3   3   3   3 102
100   3   3   3   3   3   3   3   3   3   3   3   3   3   3 102
100   3   3   3   3   3   3   3   3   3   3   3   3   3   3 102
100   3   3   3   3   3  84   3   3   3   3   3   3   3   3 102
100   3   3   3  84   3 100   3   3   3   3   3   3   3   3 102
116 117 117 117 116 117 116 117 117 117 117 117 117 117 117 118 